###################################
#XO                  X           O#
# P     ###########################
#         X#                       
######     #                       
# O ##     #                       
#   ##     #                       
#          #                       
# XX       #                       
#X       #X#                       
############                       
