######################
#   #   #            #
#   #X  #            #
# ###  X###          #
# #  X  X #          #
### # ### #     ######
#   # ### #######   O#
# X  X              O#
##### #### #P####   O#
#   #      ###  ######
######################
