 ##########################################################           
 #                                                        #           
 #     O              P                                   #           
 #                                                        #           
 #                                                        #           
 #                                                        ############ 
 ############                                                        # 
            #                                                        #
            #                                                        #
            #                                                        # 
            #                                                        #  
    ########                                                         # 
    #                                                        #########
    #                                                        #        
    #                                                        #        
    #                                  X                     #        
    #                                                        #        
    #                                                        #        
    #                                                        #        
    #                                                        #        
    #                                                        #        
    #                                                        #        
#####                                                        #        
#                                                        #####        
#                                                        #            
#                                                        #            
##########################################################            
